##########################################_____________##############################################
#                                                                                                   #
#                                                                                                   #
#                                                                                                   #
#                                 ⠀⠀⠀⠰⠿⠿⠿⢿⣿⣷⣶⣶⣶⣦⣤⣤⣤⣤⣀⣀⣀⣀⠀⠀⠀⠀⠀⠀                              #
#                                 ⠀⠀⠀⢰⣶⣦⠀⣶⣤⣤⣤⣤⣍⣉⣉⣉⡙⠛⠛⠛⠛⠏⣰⣿⡆⠀⠀⠀                              #
#                                 ⠀⠀⠀⠀⢿⡿⢠⣿⣿⣿⣿⣿⣿⣿⣿⠻⣿⣿⣿⣿⣿⣆⠸⣿⡇⠀⠀⠀                              #
#                                 ⠀⠀⠀⠀⠘⡇⢸⣿⣿⣿⣿⣿⣿⣿⡏⠀⠹⠟⠙⣿⣿⣿⠄⢻⡇⠀⠀⠀                              #
#                                 ⠀⠀⠀⠀⠀⠀⠊⣉⡉⢋⣩⡉⠻⠛⠁⣾⣀⣴⡀⢛⡉⢠⣷⠈⠇⠀⠀⠀                              #
#                                 ⠀⠀⠀⠀⠀⣠⣼⣿⣿⣿⣿⣿⣷⣿⠀⢿⣿⣿⣿⡿⢁⠚⠛⠃⠀⠀⠀⠀                              #
#                                 ⠀⠀⠀⠤⠾⠿⣿⡿⠛⣿⣿⣿⣿⣿⣷⣦⣌⣉⣉⣠⣾⡷⠂⣠⠀⠀⠀⠀                              #
#                                 ⠀⣿⢰⣶⣶⣶⣦⠀⠀⣤⣌⣉⠉⣉⡙⠛⠛⠛⠻⠟⢁⣴⣾⣿⠀⠀⠀⠀                              #
#                                 ⠀⣿⣆⠻⣿⣿⢇⣸⠀⣯⢉⣿⠀⣿⣿⣿⣿⣿⣷⠀⣿⣿⣿⣿⠀⠀⠀⠀                              #
#                                 ⠀⣿⣿⣷⡔⠐⣾⣿⠀⠛⠚⠿⠀⣿⣿⣿⣿⣿⣿⠀⣿⣿⣿⣿⠀⠀⠀⠀                             #
#                                 ⠀⣿⣿⣿⣿⣶⣿⣿⣿⣿⣿⣶⣶⣿⣿⣿⣿⣿⣿⠀⣿⣿⣿⣿⠀⠀⠀⠀                             |
#                                 ⠀⢿⣿⣿⣿⣿⣿⣿⣿⣿⣿⣿⣿⣿⣿⣿⣿⣿⣿⠀⣿⣿⠿⠋⠀⠀⠀⠀                             |
#                                 ⠰⣦⡄⠀⠀⠈⠉⠉⠉⠉⠛⠛⠛⠛⠻⠿⠿⠿⠿⠀⠛⢁⣀⡀⠲⠖⠀⠀                             |
#                                                                                                   |
#                                                                                                   |
#                                                                                                   |
#                                                                                                   |
#                                                                                                   |
#                                                                                                   |
#                                                                                                   |
#                                               ___                                                 |
#                                             | . . |                                               |
#                                              \ _ /                                                #
#                                           ___|   |___                                             #
#                                         /|           |\                                           #
#                                        /  \         /  \                                          #
#                                       /    \       /    \                                         #
#                                      /      |     |      \                                        #
#                                     0       -------       0                                       #
#                                             /     \                                               #
#                                            /       \                                              #
#                                           /         \                                             #
#                                          /           \                                            #
#                                       __/             \__                                         #
#                                                                                                   #
##########################################_____________##############################################
