#####################################################################################################
#                                                                                                   #
#                                        .-+####***=:.                                              #
#                                     :##@@@%%%%%%%%#***.                                           #
#                                   +#@%%##*+++++=*+*%%%#+.                                         #
#                                 -%@%@*+==--=---::----=%##+.                                       #
#                               .#@@@*===----::::.:::::.::#%@:                                      #
#                              :@@@*+===----::::::::::::::-+%%.                                     #
#                             -@%%#+=+===--::::.::::::::----%@%.                                    #
#                            .#-@%*==+=----:::::::.::::-----=#@%.                                   #
#                            +@@@**++==----:..:.::-::::----===+%*:                                  #
#                            #+@%#*++==---:::::::::::::----===#=++                                  #
#                           .+#@#+#*+===---::::::.::::::---==-%-+=.                                 #
#                           -=%%#@**++=%%*###+=:-::::-=+**%+++%#@*                                  #
#                           :+**%#*+***%#@@@%#*+====+@@%%@%#+#@#*.                                  #
#                           .++%%#**++*+*@#*%+*+-:-%#+%@@*##+%%#                                    #
#                            -:=*#+=+==+*=-=-===-:-+-====+*==%*                                     #
#                            :+++##*+=+=-#===--=-:-+=+#====-=#-                                     #
#                             ====%*+==--:::-----::==-----=+++.                                     #
#                             -+===**+==--:===---.:-==--:-==*=                                      #
#                                 .#***+===--+#-::-=#=====+*+.                                      #
#                                  =*#++=*++-===@#@++=+*+=#-                                        #
#                                   ++*+-+*@+++=+*+**@++=*+                                         #
#                                    =##=====+*@#%#=+=+=*+                                          #
#                                     =**====#+****#==+*-                                           #
#                                      :*#===--=+--==#+.                                            #
#                                        =%+===--===+:                                              #
#                                          .=+++++=.                                                #            
#                                                                                                   #
#                                                                                                   #
#                                                                                                   #
#                                                                                                   #
#                                                                                                   #
#                                                                                                   #
#                                            (°_°⁠)                                                  #
#                                           /(   )\                                                 #
#                                             | |                                                   #
#                                                                                                   #
#                                                                                                   #
##########################################_____________##############################################