⠀⠀⠀⠀⠀⠀⢀⠀⠀⠀⠀⠀⠀⠀⠀⠀⠀⠀⠀⠀⠀⠀⠀⠀⠀⠀⠀⠀⠀⠀
⠀⠀⠀⠀⠀⠰⠿⠿⠿⢿⣿⣷⣶⣶⣶⣦⣤⣤⣤⣤⣀⣀⣀⣀⠀⠀⠀⠀⠀⠀
⠀⠀⠀⠀⠀⢰⣶⣦⠀⣶⣤⣤⣤⣤⣍⣉⣉⣉⡙⠛⠛⠛⠛⠏⣰⣿⡆⠀⠀⠀
⠀⠀⠀⠀⠀⠀⢿⡿⢠⣿⣿⣿⣿⣿⣿⣿⣿⠻⣿⣿⣿⣿⣿⣆⠸⣿⡇⠀⠀⠀
⠀⠀⠀⠀⠀⠀⠘⡇⢸⣿⣿⣿⣿⣿⣿⣿⡏⠀⠹⠟⠙⣿⣿⣿⠄⢻⡇⠀⠀⠀
⠀⠀⠀⠀⠀⠀⠀⠀⠊⣉⡉⢋⣩⡉⠻⠛⠁⣾⣀⣴⡀⢛⡉⢠⣷⠈⠇⠀⠀⠀
⠀⠀⠀⠀⠀⠀⠀⣠⣼⣿⣿⣿⣿⣿⣷⣿⠀⢿⣿⣿⣿⡿⢁⠚⠛⠃⠀⠀⠀⠀
⠀⠀⠀⠀⠀⠤⠾⠿⣿⡿⠛⣿⣿⣿⣿⣿⣷⣦⣌⣉⣉⣠⣾⡷⠂⣠⠀⠀⠀⠀
⠀⠀⠀⣿⢰⣶⣶⣶⣦⠀⠀⣤⣌⣉⠉⣉⡙⠛⠛⠛⠻⠟⢁⣴⣾⣿⠀⠀⠀⠀
⠀⠀⠀⣿⣆⠻⣿⣿⢇⣸⠀⣯⢉⣿⠀⣿⣿⣿⣿⣿⣷⠀⣿⣿⣿⣿⠀⠀⠀⠀
⠀⠀⠀⣿⣿⣷⡔⠐⣾⣿⠀⠛⠚⠿⠀⣿⣿⣿⣿⣿⣿⠀⣿⣿⣿⣿⠀⠀⠀⠀
⠀⠀⠀⣿⣿⣿⣿⣶⣿⣿⣿⣿⣿⣶⣶⣿⣿⣿⣿⣿⣿⠀⣿⣿⣿⣿⠀⠀⠀⠀
⠀⠀⠀⢿⣿⣿⣿⣿⣿⣿⣿⣿⣿⣿⣿⣿⣿⣿⣿⣿⣿⠀⣿⣿⠿⠋⠀⠀⠀⠀
⠀⠀⠰⣦⡄⠀⠀⠈⠉⠉⠉⠉⠛⠛⠛⠛⠻⠿⠿⠿⠿⠀⠛⢁⣀⡀⠲⠖⠀⠀
⠀⠀⠀⠀⠀⠀⠀⠀⠀⠀⠀⠀⠀⠀⠀⠀⠀⠀⠀⠀⠀⠀⠀⠀⠉⠀⠀⠀⠀⠀