⠀⠀⠀⠀⠀⠀⠀⠀⠀⠀⠀⠀⣀⣤⠄⣀⡦⠀⠀⠀⠀⠀⠀⠀⠀⠀⠀⠀⠀⠀⠀⠀⠀
⠀⠀⠀⠀⠀⠀⠀⣀⣀⣤⣴⣞⣱⣣⠞⣹⠀⠀⠀⠀⠀⠀⠀⠀⠀⠀⠀⠀⠀⠀⠀⠀⠀
⠀⠀⠀⠀⠀⢠⣶⠛⠉⠀⠉⠀⠉⠙⠻⢷⣄⠀⠀⠀⠀⠀⠀⠀⠀⠀⠀⠀⠀⠀⠀⠀⠀
⠀⠀⠀⢀⡴⠟⠢⣄⡠⡴⠒⠤⡀⠀⠀⠘⢿⡦⠀⠀⠀⠀⠀⠀⠀⠀⠀⠀⠀⠀⠀⠀⠀
⠀⠀⠀⣟⣾⡟⠀⣾⣿⡶⠀⡼⠃⠀⠀⠀⠈⣷⣤⣄⡀⠀⠀⠀⠀⠀⠀⠀⠀⠀⠀⠀⠀
⠀⠀⠀⣣⣁⣀⡾⢇⣁⡠⠞⠁⠀⠀⠀⠀⠀⣿⠄⣸⣇⠀⠀⠀⠀⠀⢰⡄⠀⠀⠀⠀⠀
⠀⠀⢠⡏⠸⠿⣾⣫⡯⠿⣵⡀⠀⠀⠀⠀⠀⢿⣷⠟⠁⠀⠀⠀⠀⢰⡿⢷⡄⠀⠀⠀⠀
⠀⠀⢸⣇⠀⠀⠀⠀⠉⠃⠀⠀⠀⠀⠀⠀⠀⣹⣧⣀⡀⠀⠀⠀⠀⢸⡏⢸⣾⠀⠀⠀⠀
⠀⠀⠈⢿⡄⠀⠀⠀⠀⠀⠀⠀⠀⢀⡀⠀⠀⣽⡅⢀⡿⠀⠀⠀⠀⢺⠓⠀⣿⠀⠀⠀⠀
⠀⠀⠀⣸⣗⡂⠀⠀⠀⠀⠀⠀⠀⣸⠁⠀⠀⢹⢇⡞⠁⠀⠀⠀⣠⡾⠀⠀⣻⡀⠀⠀⠀
⠀⠀⢀⣿⡇⠀⠀⠀⠀⠀⠀⠀⠀⣿⠀⠀⠀⢾⣁⠤⣄⠀⠀⡴⡽⠁⠀⢰⢻⠃⠀⠀⠀
⠀⠀⠀⣿⡇⠀⠀⠀⠀⠀⠀⠀⠀⣹⠐⠀⠀⢻⢻⣀⣸⣀⣴⡟⠀⠀⠀⣸⣿⠀⠀⠀⠀
⠀⠀⢰⣿⡇⠀⠀⠀⢀⣄⠀⠀⢠⡿⣄⢰⡀⠿⡀⠙⠛⠛⠉⠀⠀⢀⣴⣿⠃⠀⠀⠀⠀
⠀⠀⠀⢿⣷⡀⠀⠀⠒⠛⠋⠀⠸⢷⡹⣞⣷⣦⠟⠀⠀⠀⠀⣀⣴⣿⠛⠁⠀⠀⠀⠀⠀
⠀⠀⠀⠈⠻⡷⠶⠄⠀⠦⣴⡴⠿⠃⠉⠛⣩⣤⣦⣶⣶⣶⡿⠿⠋⠁⠀⠀⠀⠀⠀⠀⠀
⠀⠀⠀⠀⠀⡇⠀⠀⠀⠀⣿⠃⠀⠀⠀⣸⠏⠀⠉⠁⠉⠁⠀⠀ ⠀⠀⠀⠀⠀⠀⠀⠀⠀
⠀⡤⠒⠉⠉⠉⣽⠋⠉⠉⠋⠀⠀⠀⠀⢹⠀⠀⠀⠀⠀⠀⠀⠀ ⠀⠀⠀⠀⠀⠀⠀⠀⠀
⣸⠧⠤⠤⠤⠤⢿⠦⠦⠴⠶⠶⠶⠶⡶⢾⠶⠂⠀⠀⠀⠀⠀⠀⠀⠀⠀⠀⠀⠀⠀⠀⠀