#####################################################################################################
#                                       :============                                               #     
#                                     ==+++=======+=+==:                                            #        
#                                   ==++=============++=+                                           #         
#                                  =++++===---------==++++                                          #          
#                                  +++==-------------==+++                                          #          
#                                 :=+==---:--::::---===+++:                                         #           
#                                 :===-----:-::::::--=+++=-                                         #           
#                                 -===--::::::::--::--==+==                                         #           
#                                +--@@-**##*@+==%#%#*#=@%*=*:                                       #             
#                                 :===+%=%#%+@:+=*+#=#*#@+=-+                                       #             
#                                 ++=%-+===---::*=+====-=+#=                                        #             
#                                   ===-*--=%--::-#=--=#=++=                                        #            
#                                   :==----=+--::-=*+--====-                                        #            
#                                    -====#-===+*+=-%*+++=                                          #          
#                                    ===-+=--===-==+=+==-                                           #         
#                                    ====+=*=--:+*+=====                                            #         
#                                   @ -=====+===*====+=                                             #        
#                                  %@   -=--======--== @#                                           #         
#                                #%%%*   .=--------=+  *%%%%%%#                                     #               
#                             *%%%%%%@:     -++++**=   :%%%@@%%%%%%%@#                              #                      
#                          %%%@@@%%%%%@:       .:-+    .#%%@@@%@@%%@@%%%@                           #                         
#                      %%%@%%%%%%%%%%%@.        %%%%- ..@@%%%@%%%%%%%%%%@=                          #                          
#                   *%%@%%%%%%%@%%%%%%%%=.      %%%%%@-...@%%%%%@@@%%%%%%%%                         #                           
#                  %%%%%%%%%%%%@@%%%%%%%%.-    #%%%%%=*: .#@%%@@%@%%%%%%%@@                         #                           
#                  %%%%%%%%%%%%%%%@%%%%%%@. .. .--@%@ .....@%%%%%%%%@%%%%%@                         #                           
#                  %%%%%%%%%%%%%%%%%%%%%%%=.     =%%%*.  ..:%%%@%%%@@@%%%%@                         #                           
#                                                                                                   #
#                                                                                                   #
#                                                                                                   #
#                                                                                                   #
#                                                                                                   #
#                                                                                                   #
#                                                                                                   #
#                                            (°_°⁠)                                                  #
#                                           /(   )\                                                 #
#                                             | |                                                   #
#                                                                                                   #
#                                                                                                   #
##########################################_____________##############################################