#####################################################################################################
#                                  ----------:::--:::-                                              #     
#                                -===+::::--:-::::::-:::--                                          #         
#                               -=+*++-=-::--::--::::-:::--                                         #          
#                               -=+=++==----:--:---:-::-==:                                         #          
#                              -==-----------=:--===---:---:                                        #           
#                             --==-------------==-==+==-=--=-                                       #            
#                            -=+-----------==-===-===+-===-=-                                       #            
#                           ---=--------------====+-===+==--=                                       #            
#                           ---==-----------=---====+=======-                                       #            
#                           -::===-==---=++++=======++**+===+=-                                     #              
#                           -::===+*+=--=++###+#*+=====+#*+*+=+-                                    #               
#                           -::=+###**--===+*++==----==+****=*==                                    #                      
#                               -=+*++-=-::--::--::::-:::--                                         #          
#                          -::-=+++*+==-===-=-----=====++++#+=*+=                                   #                
#                           -:-++--==--====-----======+++++++=+*=-                                  #                 
#                              =+=---=-=====----===++++=++++#=+*=-.                                 #                  
#                              ====-====*#++-=-=====++==++*#*=++==:                                 #                  
#                              ==+======+==----=========+++#*+++==:                                 #                  
#                              ===+=======---==========++++*+**===:-=-                              #                     
#                              -===*===***+++=====++++++*++*##*=-=--===-                            #                       
#                              -==++*=+=+*+++===+++++***++++#++*===+====                            #                       
#                              --=++*++=++=---===+*****++=++*##*==+++++-                            #                       
#                              ---=++++*======++******++===++*##=+*+**+-                            #                       
#                               --==+++***+**********++====+++**=*+=##*=                            #                       
#                               -==+=++**#*#+++++++++=======+++++#+**##*-                           #                        
#                                -+++*++####+++++++========++++*###*######                          #                         
#                               --=-+*****####+++++++=======+++*###########                         #                          
#                             --:----=*#**####++++++========++#############                         #                          
#                       -----------=+*#######++++++=========##############                          #                         
#                       --------*##+*########+++===========###############                          #                         
#                       ---***#*#*++*########+============*###############                          #                                                
#                                                                                                   #
#                                                                                                   #
#                                            (°_°⁠)                                                  #
#                                           /(   )\                                                 #
#                                             | |                                                   #
#                                                                                                   #
#                                                                                                   #
##########################################_____________##############################################