#####################################################################################################
#                                          --=====++=                                               # 
#                                       ----=====+*++==                                             #   
#                                     -----------=++*+===                                           #     
#                                   ------------+++++*+++=                                          #      
#                                  -----------=-=------=++==                                        #        
#                                 ----:-:----------------====                                       #         
#                              -----:::-:--=--------:-----=++=                                      #          
#                              ---:-:--==----------------==+==                                      #          
#                              ------=+-------------:-----++==                                      #          
#                              -----=*-=++++++==-===+=-==-=+==                                      #          
#                              =---=*==+***+++=---=++*-#=---==                                      #          
#                              ====+#=-------=------==-------=                                      #          
#                              ====+*==--------------------:                                        #        
#                               =======------==----==------:                                        #        
#                                --:-+-=---==*=---=-=+=-----                                        #        
#                                -----+===+++====-----===----                                       #         
#                              ===--=+*==--=+*+++===----==---                                       #         
#                             ==---==+#*==-=------------=====                                       #         
#                            =====---*##===----=------=-====*####=                                  #              
#                           =-=-=-==####*====--------++==--=########                                #                
#                           ---##########*+++++++++==*=----*########                                #                
#                           *##############=+++======++==***##++####                                #                
#                           ################===----===+=:+#*:####:##                                #                
#                           #################+:-------==-:##*####=##                                #                
#                           ##################+:-------+-::##:##:###                                #                
#                           ###################==:-----+--:-########                                #                
#                                                                                                   #
#                                                                                                   #
#                                                                                                   #
#                                             (°_°⁠)                                                 #
#                                            /(   )\                                                #
#                                              | |                                                  #
#                                                                                                   #
#                                                                                                   #
##########################################_____________##############################################