#####################################################################################################
#                                                                                                   #
#                                       :***#**#*#*###.                                             # 
#                                    .#*#%##%%#+=+*##*##%                                           # 
#                                   ==***#**#++*+=+-:..-*#-                                         # 
#                                  .#=--=++-::.      ....+%:                                        # 
#                                  +::... .          .....*#                                        # 
#                                 :=::.. .           .....-#*                                       # 
#                                 =-.....  .           ...:+*                                       # 
#                                  :...                 ..-++                                       # 
#                                  -.:++*+-...  --**+==. .-+-                                       # 
#                                 .=--:*:+:*=. - -.#:#:-. :=:                                       # 
#                                 .-........=:.   .     ..:.                                        # 
#                                  :.. .. . ::          ..::                                        # 
#                                  :..   .-::. ...       .::.                                       # 
#                                  :..  .-::--:-  :.  ....-..                                       # 
#                                  =....=-=++*==-::.. ...::                                         # 
#                                   -...=*:-=++-=.*=: ..:-=                                         # 
#                                    =+=+:.-=-+:  .+=++==-:                                         # 
#                                    -###*=::...=.+*****=:-=                                        # 
#                                      ***==---===+**+*=.: :%#                                      # 
#                                     %:=#**++*+=#***:..   #%%#=                                    # 
#                               %@@@%%@ ...+****++-..:    %#%##%%%-                                 # 
#                         @%%%%%@@@%#%@  +....:::..      %######%%%%%%-                             # 
#                      %%%%%%%%@@@%%%%@    :. ..        @#######%%%%%%%%%                           # 
#                      %%%%%%%%%%%%%%%+    .:%         *########%%%%%%%%%                           #                                              
#                                                                                                   #
#                                                                                                   #
#                                                                                                   #
#                                                                                                   #
#                                                                                                   #
#                                                                                                   #
#                                                                                                   #
#                                             (°_°⁠)                                                 #
#                                            /(   )\                                                #
#                                              | |                                                  #
#                                                                                                   #
#                                                                                                   #
##########################################_____________##############################################