        +-------+        
        |   B   |        
        |   O   |        
        |   S   |        
        |   S   |       
+-------+-------+-------+
|       |       |       |
|       |       |       |
|       |       |       |
+-------+-------+-------+
|       |       |       |
|       |       |       |
|       |       |       |
+-------+-------+-------+
|       |       |       |
|       |       |       |
|       |       |       |
+-------+-------+-------+
