        +-------+        
        |       |        
        |       |        
        |       |        
+-------+-------+-------+
|       |       |       |
|   X   |       |       |
|       |       |       |
+-------+-------+-------+
|       |       |       |
|       |       |       |
|       |       |       |
+-------+-------+-------+
|       |       |       |
|       |       |       |
|       |       |       |
+-------+-------+-------+
